111111111111
10C0C00000C1
1CP0000000E1
10000C000001
111111111111
