111111
1000C1
10P0E1
100001
111111
