111111111111
10C0C00100C1
1CP0000100E1
10000C010001
111111111111
