111111111111
10C0C000N0C1
1CP0111000E1
10001C100001
111111111111
